########################
#       #              #
#       #              #
#       #              #
#                      #
#                      #
#~~~~~~~ ~~~~~~~~~~~~~~#
#                      #
#                      #
#                      #
#                      #
########################